########
#  #   #
#   X  #
# X## #####
## #O ##  #
 # #O   X #
 # #O ##  #
 # #O### ##
 #P   ##  #
 ## X     #
  ######  #
       ####