#############
#O#         #
# #       # #
#         # #
#         # #
#        PX #
#         # #
#         # #
#         XO#
####  #######
    ##