#############
#          O#
#      ######
#           #
#           #
#######  PX #
#      X    #
#           #
#     O######
#############